..!......
.######..
.#....#..
.#....#..
.#....#.#
.#....#..
.######..
.....!...