..!.......
.######...
.#....#...
.#....#...
.#....#.#.
.#....#...
.#######..
.....!....