..!......
.######..
.#.!..#..
.#!.!.#..
.#.!..#..
.#...!#..
.####!!#.
.........